BEKEKEEEEEEEEEEEEEEEEEEEEEEKEKEA
FXFHFZZZZZZZZZZZZZZZZZZZZZZFHFXF
FMFMFZZZZZZZZZZZZZZZZZZZZZZFMFMF
FMFMFZZZZZZZZZZZZZZZZZZZZZZFMFMF
FMFMFZZZZZZZZZZZZZZZZZZZZZZFMFMF
FMFMDEEEEEEAZZZZZZZZBEEEEEECMFMF
FMFMMMMMMMMFZZZZZZZZFMMMMMMMMFMF
FMDEEEEEEAMJEKEKKEKEGMBEEEEEECMF
FMMMMMMMMFMFMFZFFHFMFMFMMMMMMMMF
JEEEEEEWMYMYMFZFFMFMYMYMUEEEEEEG
FHMMMMMMMMMMMFZDCMYMMMMMMMMMMMMF
JEEAMBEAMBEAMDWMMMMMBEAMBEAMBEEG
JEECMDECMDECMMMMPUAMDECMDECMDEEG
FMMMMMMMMMMMMVMBAZFMMMMMMMMMMMHF
JEEEEEEWMVMVMFMFFZFMVMVMUEEEEEEG
FMMMMMMMMFMFMFHFFZFMFMFMMMMMMMMF
FMBEEEEEECMJEIEIIEIEGMDEEEEEEAMF
FMFMMMMMMMMFZZZZZZZZFMMMMMMMMFMF
FMFMBEEEEEECZZZZZZZZDEEEEEEAMFMF
FMFMFZZZZZZZZZZZZZZZZZZZZZZFMFMF
FMFMFZZZZZZZZZZZZZZZZZZZZZZFMFMF
FMFMFZZZZZZZZZZZZZZZZZZZZZZFMFMF
FXFHFZZZZZZZZZZZZZZZZZZZZZZFHFXF
DEIEIEEEEEEEEEEEEEEEEEEEEEEIEIEC