BEEEEEEEEEEEEEEEEEEEEEEEEEEEEEEA
FZZZZZZZZZZZZZZZZZZZZZZZZZZZZZZF
FZBAZBEEEEEEEEEEEEEEEEEEEEAZBAZF
FZDCZFZZZZZZZZZZZZZZZZZZZZFZDCZF
FZZZZDEEEEEEEEEEEEEEEEEEEECZZZZF
FZBEAZZZZZZZZZZZZZZZZZZZZZZBEAZF
FZFZFZZZZZZZZZZZXZZZZZZZZZZFZFZF
FZFZFZZMZZZZZZZMMZZZZZZZMZZFZFZF
FZFZFZZZZZZZZZZZZZZZZZZZZZZFZFZF
FZFZFZZZZZZZZZZZZZZZZZZZZZZFZFZF
CZDECZZZZZZZZZZZZZZZZZZZZZZDECZD
ZZZZZZZMZZZZZZZMMZZZZZZZMZZZZZZZ
AZBEAZZZZZZZZZZZZZZZZZZZZZZBEAZB
FZFZFZZZZZZZZZZZZZZZZZZZZZZFZFZF
FZFZFZZZZZZZZZZZHZZZZZZZZZZFZFZF
FZFZFZZZZZZZZZZZZZZZZZZZZZZFZFZF
FZFZFZZMZZZZZZZMMZZZZZZZMZZFZFZF
FZFZFZZZZZZZZZZZZZZZZZZZZZZFZFZF
FZDECZZZZZZZZZZZZZZZZZZZZZZDECZF
FZZZZBEEEEEEEEEEEEEEEEEEEEAZZZZF
FZBAZFZZZZZZZZZZZZZZZZZZZZFZBAZF
FZDCZDEEEEEEEEEEEEEEEEEEEECZDCZF
FZZZZZZZZZZZZZZPZZZZZZZZZZZZZZZF
DEEEEEEEEEEEEEEEEEEEEEEEEEEEEEEC

